rr0011111111111111111001111111111111111111
111111111111111111111001111111111111111111
111111111111111111111001111111111111111111
111111111111111111111111111111111111111111
111111111111111111111111111111111111111111
111111111111111111111111111111111111111111
111111111111111111111111111111111111111111
111111111111111111111111111111111111111111
111111111111111111111111111111111111111111
000000000000000000000000000000000000000000
111111111111111111111111111111111111111111
111111111111111111111111111111111111111111