SH11SD11SG11EG11ED11EH11EB11BD11BH11BB11bG
111111111111111111111111111111111111111111
111111111111111111111111111111111111111111
bD11bH11bB11111111111111111111111111111111
111111111111111111111111111111111111111111
111111111111111111111111111111111111111111
111111111111111111111111111111111111111111
111111111111111111111111111111111111111111
111111111111111111111111111111111111111111
000000000000000000000000000000000000SH1100
111111111111111111111111111111111111111111
111111111111111111111111111111111111111111